%%%%%%%%%%%%%%%%%%%%
%^S*%^^*^^^%^^*   ^%
%^S%^%^%%**%%^%%% ^%
%SS%*^^^^%**%^^^^%^%
%^%^%%^%%  %%^%%^%^%
%^^^^^ ****%^%S^^^ %
%S%^^^^%%%%%%^%^^%^%
%^%^^^^%  ^^%S%^^%^%
%^%^^^^% %%%%^%^^%^%
%^S%^^^^^^^^^^%^^%^%
%^%%^%^%%%%%%^%%% ^%
%^**%^^R^^^^%^^SS ^%
%%%%%%%%%%%%%%%%%%%%
