%%%%%%%%%%%%%%%%%%%%
%^S^^^^%*  *%S^^S^S%
%^%%^^^%%  %%^^^%%^%
%^%^S%^^^^^^^^%^%S %
%^%%^%^%%%%%%^%^%%^%
%^SS^^^^R^^^^^^^SS^%
%%%%%%%%%%%%%%%%%%%%
