%%%%%%%%%%%%%%%%%%%%
%S*      S  ~^^%*  %
%^%%S%%^%%^%%^%%*% %
%^*   S  R  S~^^*% %
%%%%%%%%%%%%%%%%%% %
%SSS^S    S ~~^^*  %
%%%%%%%%%%%%%%%%%%%%
