%%%%%%%%%%%%%%%%%%%%%%%%%%%%
%^^^^^^^S^^^^%%^^^^^^^S^^^^%
%^%%%%^%%%%%^%%^%%%%%^%%%%^%
%^%%%%^%%%%%^%%^%%%%%^%%%%^%
%^%%%%^%%%%%^%%^%%%%%^%%%%^%
%^^^^^^S^^^^^^S^^^^^^^^    %
%^%%%%^%%^%%%%%%%%^%%^%%%%^%
%^%%%%^%%^%%%%%%%%^%%^%%%%^%
%^^^^^^%%^^^^%%^^^^%%^^^^^^%
%%%%%%^%%%%%~%%*%%%%%^%%%%%%
%%%%%%^%%%%%~%%*%%%%%^%%%%%%
%%%%%%^%   ~~^^*    %^%%%%%%
%%%%%%^% %%%%^^%%%% %^%%%%%%
%     SS %*~~*** *%      ~~%
%%%%%%^% %%%%%%%%%% %^%%%%%%
%%%%%%^%   ~~^^*    %^%%%%%%
%%%%%%^% %%%%%%%%%% %^%%%%%%
%^^^^^^^^^%%^^^^^^S^^^^^^  %
%^%%%%^%%%%%^%%^%%%%%^%%%%^%
%^%%%%^%%%%%^%%^%%%%%^%%%%^%
%^S^%%^^^^^^^^^^^^^^^^%%^^^%
%%%^%%^%%^%%%%%%%%^%%^%%^%%%
%%%^%%^%%^%%%%%%%%^%%^%%^%%%
%^^^^^^%%^^^^%%^^^^%%^^^^^^%
%^%%%%%%%%%%^%%^%%%%%%%%%%^%
%^^^^^^^S^^^^R^^^^^S^^^^^^^%
%%%%%%%%%%%%%%%%%%%%%%%%%%%%
