%%%%%%%%%
%SSS*SSS%
%%%%%%%S%
%RSS**SS%
%*%%S%%S%
%S%%S*S%%
%%%%%%%%%
