%%%%%%%%%%%%%%%%%%%%
%^S^^%^^^S^^^%^^^ ^%
%^%%S%^%%%%%%^%^^%^%
%^%^^^^^^S^S^^^^%^ %
%^%^%%^%%  %%^%%^%S%
%^^S^^^%*  *%^^^^^^%
%^%^%%^%%%%%%^%%^%^%
%^%S^^^^^^S^^^^^^%^%
%^%%^%^%%%%%%^%^^%S%
%^^^^%^^^R^^^^%^^^ %
%%%%%%%%%%%%%%%%%%%%
