%%%%%
%SSS%
%SSS%
%~S^%
%SSS%
%SSS%
%S^S%
%SSS%
%RSS%
%%%%%
