%%%%%%%%
%SSS SS%
%SSSRS %
%^%%%%S%
%^%SS S%
%S%S%%%%
%S%SSSS%
%%%%%%%%
