%%%%%%%%%
%S^%R^S%%
%^%^%^%%%
%S^S^S^%%
%%%%%%%%%
