%%%%%%%%
%S^SR^S%
%S%%%%%%
%^SS^S%%
%%%%%%%%
