%%%%%%%%%%%%%%%%%%%%%%%%%%%%%%%%%%%%%
%                                  R%
%            %   ~~~^~~~            %
%            %  ~~   ~~             %
%  ~~~~~~~~  % ~ ^   ^ ~     ~~~    %
% ~~~~~~~~   %  ~~   ~~             %
%  ~~~~~~~~  %   ~~~^~~~            %
%   ~~~~~~~~ %      %         ~~~   %
%  ~~~~~~~~  %  ~   %   ^           %
% ~~~~~~~~   %  ~~  %  ~~   ~~~     %
%  ~~~~~~~~  %  ~   %   ~           %
%   ~~~~~~~~ %  ^   %   ~     ~~~   %
%            %  ~~  %  ~~           %
%%%%%%%%%%%%%%      %%%%%%%%%%%%%%%%%
%            %  ~~~^~~~             %
%  ~~~~~~~~  % ~~   ~~        ~~~~  %
%  ~~~~~~~~  %~ ^     ^ ~           %
%  ~~~~~~~~  ~~~ ~~~ ~~~ ~~~        %
%            ^ ~ ^ ~ ^ ~ ^          %
%            ~~~ ~~~ ~~~ ~~~        %
%S                                  %
%%%%%%%%%%%%%%%%%%%%%%%%%%%%%%%%%%%%%
