%%%%%%%
%  ^ R%
% %%% %
%  %  %
%% ~ %%
%S %%%%
%%%%%%%
