%%%%%%%%%%%%%%%%%%%%%%%%%
%S^ RS ^^^S~~^^* ^^^    %
%^^  ~S^  ^^~^^~^^  ^^^ %
%^S  ^^^  ^~~^^~~^  ^^^ %
%^^    ^^^~~~^^* ^^^ *  %
%^^  ^S^  ^^~^^~^^  ^S^ %
%^^  ^^^  ^~~^^~~S  ^^^ %
%^S    ^^^~~~^S* ^^^ ^  %
%%%%%%%%%%%%%%%%%%%%%%%%%
