%%%%%%%%%%%%%%%%%%%%%%%%%%%%%%%
%S%^^^^^^^^^^%%** %  ^%%%%^^^^%
%^%^%%%%%%%S%%%%%% %%%%%%%^%%^%
%^^^^^^^S^^S%^^^%^S^^^S^^^^^^ %
%%%%%^^^%%%^^^*   ^^%^%S^^%^%%%
%^%%%^%%%%%^%%%%%%%^%%%^%^%%%%%
%    ^^S^^^^^^^RSS^^^%^^^%~^^^%
%%%%%%%%%%%%%%%%%%%%%%%%%%%%%%%
