%%%%%%
%~~S%%
%S%S~%
%S%~S%
%~RS~%
%S%%%%
%~~S%%
%%%%%%
