%%%%%
%^S^%
%%R^%
%^S^%
%%%%%
