%%%%%%%%%%%%%%%%%%%%%
%S*  ~S~  S~^SS^R  S%
%^%%^%%^%%S%%^%%*%^ %
%^%% %^S^^^S~^^* S%%%
%%%%%%%%%%%%%%%%%%%%%
