%%%%%%%%%
%S^SSSSS%
%%%%S%% %
%S^SRSSS%
%S%%S%%S%
%S%SS^SS%
%%%%%%%%%
