%%%%%%%%%%%%%%%%%%%%%%%%%%%%%%%%%%%%%%
%                                   R%
% %%%%%%%%%%%%%%%%%%% %%%  %%%%%%%%  %
%*%%   %   %      %%% %%%    %%***   %
%*%% % % % % %%%% %%%%%%%%%  %%  %%%%%
%*%% % % % % %    %%*** ^    %%  ~   %
% %% %*% % % %%%%%  %%%    %%%%%%    %
% %% %*% %   %   ^ %%  %%%%%%%%%  ~  %
% %% %*% %%%%%%%% %%    ^   %%  %%%% %
% %% %   %%~~~****%%%%%%%%%  %%  ^   %
%    %%% %% %%%%%^%  ***  %%  %%%%%% %
%%%%%%   ^  %       %    %%  %%  ~   %
%      %%%%%%%%%   %%    %%  %%  %%%%%
% %%%%%%      %       %%%%%  %%    % %
%   ***    %%%%  ^   %%%%%  %%%%%% % %
%%%%%%%%   %   ~***~       %%%%%%  % %
%S         %%%%%%%%%%%%%%%****^    % %
%%%%%%%%%%%%%%%%%%%%%%%%%%%%%%%%%%%%%%
