%%%%%%%%%%
%S  ~*  R%
%%%%%%%%%%
